Albania=Albanya
Andorra=Andorra
Armenia=Armenya
Austria=Austria
Azerbaijan=Azerbaijan
Belarus=Belarus
Belgium=Belhika
Bosnia and Herzegovina=Bosnia at Herzegovina
Bulgaria=Bulgarya
Croatia=Kroasya
Cyprus=Siprus
Czech Republic=Republika ng Tsek
Denmark=Denmarka
Estonia=Estonya
Faroe Islands=Faroe Islands
Finland=Finlandya
France=Pransya
Georgia=Heorhiya
Germany=Alemanya
Gibraltar=Gibraltar
Greece=Gresya
Greenland=Greenland
Guernsey=Guernsey
Hungary=Hungarya
Iceland=Iceland
Ireland=Irelanda
Isle of Man=Isla ng Man
Italy=Italya
Jersey=Jersey
Latvia=Latvia
Liechtenstein=Liechtenstein
Lithuania=Lithuania
Luxembourg=Luxembourg
Malta=Malta
Moldova=Moldova
Monaco=Monako
Montenegro=Montenegro
Netherlands=Netherlands
North Macedonia=Hilagang Masedonya
Norway=Norway
Poland=Polonya
Portugal=Portugal
Romania=Romania
Russia=Rusya
San Marino=San Marino
Serbia=Serbia
Slovakia=Slovakia
Slovenia=Slovenia
Spain=Espanya
Sweden=Sweden
Switzerland=Switzerland
Turkey=Turkiya
Ukraine=Ukraina
United Kingdom=United Kingdom

Afghanistan=Afghanistan
Bahrain=Bahrain
Bangladesh=Bangladesh
Bhutan=Bhutan
Brunei=Brunei
Cambodia=Kambodya
China=Tsina
Hong Kong=Hong Kong
India=India
Indonesia=Indonesia
Iran=Iran
Iraq=Iraq
Israel=Israel
Japan=Hapon
Jordan=Jordan
Kazakhstan=Kazakhstan
Kuwait=Kuwait
Kyrgyzstan=Kyrgyzstan
Laos=Laos
Lebanon=Lebanon
Macau=Macau
Malaysia=Malasya
Maldives=Maldives
Mongolia=Mongolia
Myanmar=Myanmar
Nepal=Nepal
Oman=Oman
Pakistan=Pakistan
Philippines=Pilipinas
Qatar=Qatar
Saudi Arabia=Saudi Arabia
Singapore=Singapore
South Korea=Timog Korea
Sri Lanka=Sri Lanka
Syria=Syria
Tajikistan=Tajikistan
Thailand=Taylandiya
Timor-Leste=Timor-Leste
Turkmenistan=Turkmenistan
United Arab Emirates=United Arab Emirates
Uzbekistan=Uzbekistan
Vietnam=Vietnam
Yemen=Yemen
Anguilla=Anguilla
Antigua and Barbuda=Antigua at Barbuda
Aruba=Aruba
Bahamas=Bahamas
Barbados=Barbados
Belize=Belize
Bermuda=Bermuda
British Virgin Islands=British Virgin Islands
Canada=Kanada
Cayman Islands=Cayman Islands
Costa Rica=Costa Rica
Cuba=Kuba
Dominica=Dominica
Dominican Republic=Dominican Republic
El Salvador=El Salvador
Grenada=Grenada
Guatemala=Guatemala
Haiti=Haiti
Honduras=Honduras
Jamaica=Hamaika
Mexico=Mehiko
Montserrat=Montserrat
Nicaragua=Nicaragua
Panama=Panama
Saint Kitts and Nevis=Saint Kitts at Nevis
Saint Lucia=Saint Lucia
Saint Vincent and the Grenadines=Saint Vincent at Grenadines
Trinidad and Tobago=Trinidad at Tobago
Turks and Caicos Islands=Turks and Caicos Islands
United States=Estados Unidos

Argentina=Arhentina
Bolivia=Bolivia
Brazil=Brazil
Chile=Tsile
Colombia=Kolombya
Ecuador=Ekwador
French Guiana=French Guiana
Guyana=Guyana
Paraguay=Paraguay
Peru=Peru
Suriname=Suriname
Uruguay=Uruguay
Venezuela=Venezuela

Algeria=Algerya
Angola=Angola
Benin=Benin
Botswana=Botswana
Burkina Faso=Burkina Faso
Cabo Verde=Cabo Verde
Cameroon=Kamerun
Chad=Chad
Comoros=Komoros
Congo (DRC)=Congo (DRC)
Cote d'Ivoire=Côte d'Ivoire
Djibouti=Djibouti
Egypt=Ehipto
Equatorial Guinea=Equatorial Guinea
Eswatini=Eswatini
Ethiopia=Etiyopiya
Gabon=Gabon
Gambia=Gambia
Ghana=Ghana
Guinea=Guinea
Kenya=Kenya
Lesotho=Lesotho
Liberia=Liberia
Libya=Libya
Madagascar=Madagaskar
Mali=Mali
Mauritania=Mauritania
Mauritius=Mauritius
Morocco=Morocco
Mozambique=Mozambik
Namibia=Namibya
Niger=Niger
Nigeria=Nijerya
Rwanda=Rwanda
Senegal=Senegal
Seychelles=Seychelles
Sierra Leone=Sierra Leone
Somalia=Somalia
South Africa=Timog Aprika
South Sudan=South Sudan
Sudan=Sudan
Tanzania=Tanzania
Togo=Togo
Tunisia=Tunisia
Uganda=Uganda
Zambia=Zambya
Zimbabwe=Zimbabwe

Australia=Australya
Cook Islands=Cook Islands
Fiji=Fiji
French Polynesia=French Polynesia
Guam=Guam
Kiribati=Kiribati
New Caledonia=New Caledonia
New Zealand=New Zealand
Papua New Guinea=Papua New Guinea
Samoa=Samoa
Solomon Islands=Solomon Islands
Tonga=Tonga
Vanuatu=Vanuatu
settings=Mga Setting
changeLanguage=Palitan ang Wika
showPersistentNotification=Ipakita ang Palagiang Notipikasyon
switchToLightMode=Lumipat sa Liwanag na Mode
switchToDarkMode=Lumipat sa Madilim na Mode
faqTitle=Mga Madalas Itanong
q1=Ano ang NetTide?
a1=Ang NetTide ay isang mobile na aplikasyon na tumutulong sa iyo na makahanap ng pinakamahusay na mobile operator kapag ikaw ay naglalakbay.
q2=Paano ito gumagana?
a2=May database ang NetTide ng mga mobile operator mula sa iba’t ibang bansa. Maaari kang maghanap ng isang bansa at makakuha ng listahan ng mga operator kasama ang kanilang presyo kada megabyte.
q3=Maaari ko bang baguhin ang mga presyo?
a3=Oo, maaari mong baguhin ang presyo para sa bawat operator. Kapaki-pakinabang ito kung makakakita ka ng mas magandang alok o kung luma na ang mga presyo sa app.
q4=Maaari ko bang i-disable ang mga operator?
a4=Oo, maaari mong i-disable ang mga operator na ayaw mong makita sa listahan.
nettide=NetTide
listOfCountries=Listahan ng mga Bansa
faq=FAQ
enableDisableExpensive=I-enable/I-disable ang Mamahaling Mga Network
disableAll=I-disable Lahat
enableAll=I-enable Lahat
disableAllOperators=I-disable ang Lahat ng Operator
enableAllOperators=I-enable ang Lahat ng Operator
areYouSure=Sigurado ka bang gusto mong {action} lahat ng operator?
cancel=Kanselahin
allOperatorsDisabled=Lahat ng operator ay na-disable.
allOperatorsEnabled=Lahat ng operator ay na-enable.
searchForACountry=Maghanap ng bansa...
enableDisableExpensiveNetworks=I-enable/I-disable ang Mamahaling Mga Network
disableNetworksMoreThan=I-disable ang mga network na may presyong higit sa
enableNetworksMoreThan=I-enable ang mga network na may presyong higit sa
disable=I-disable
enable=I-enable
expensiveNetworksDisabled=Na-disable ang mga mamahaling network.
expensiveNetworksEnabled=Na-enable ang mga mamahaling network.
selectLanguage=Pumili ng Wika
errorDownloadingLanguage=Error sa pag-download ng wika
modifiedCountries=Binagong Mga Bansa
noCountriesModified=Wala pang nababagong bansa.
onboarding1Title=Maligayang Pagdating sa NetTide
onboarding1Subtitle=Hanapin ang pinakamahusay na mobile operator kapag ikaw ay naglalakbay.
onboarding2Title=Baguhin ang Presyo
onboarding2Subtitle=Maaari mong baguhin ang presyo para sa bawat operator.
onboarding3Title=I-disable ang Mga Operator
onboarding3Subtitle=Maaari mong i-disable ang mga operator na ayaw mong makita sa listahan.
getStarted=Simulan
skip=Laktawan
next=Susunod
editPriceFor=Baguhin ang presyo para sa
enterNewPricePerMB=Ilagay ang bagong presyo kada MB
save=I-save
price=Presyo
tapToEdit=pindutin upang baguhin
