Albania=Albanie
Andorra=Andorre
Armenia=Arménie
Austria=Autriche
Azerbaijan=Azerbaïdjan
Belarus=Biélorussie
Belgium=Belgique
Bosnia and Herzegovina=Bosnie-Herzégovine
Bulgaria=Bulgarie
Croatia=Croatie
Cyprus=Chypre
Czech Republic=République tchèque
Denmark=Danemark
Estonia=Estonie
Faroe Islands=Îles Féroé
Finland=Finlande
France=France
Georgia=Géorgie
Germany=Allemagne
Gibraltar=Gibraltar
Greece=Grèce
Greenland=Groenland
Guernsey=Guernesey
Hungary=Hongrie
Iceland=Islande
Ireland=Irlande
Isle of Man=Île de Man
Italy=Italie
Jersey=Jersey
Latvia=Lettonie
Liechtenstein=Liechtenstein
Lithuania=Lituanie
Luxembourg=Luxembourg
Malta=Malte
Moldova=Moldavie
Monaco=Monaco
Montenegro=Monténégro
Netherlands=Pays-Bas
North Macedonia=Macédoine du Nord
Norway=Norvège
Poland=Pologne
Portugal=Portugal
Romania=Roumanie
Russia=Russie
San Marino=Saint-Marin
Serbia=Serbie
Slovakia=Slovaquie
Slovenia=Slovénie
Spain=Espagne
Sweden=Suède
Switzerland=Suisse
Turkey=Turquie
Ukraine=Ukraine
United Kingdom=Royaume-Uni
Afghanistan=Afghanistan
Bahrain=Bahreïn
Bangladesh=Bangladesh
Bhutan=Bhoutan
Brunei=Brunéi
Cambodia=Cambodge
China=Chine
Hong Kong=Hong Kong
India=Inde
Indonesia=Indonésie
Iran=Iran
Iraq=Irak
Israel=Israël
Japan=Japon
Jordan=Jordanie
Kazakhstan=Kazakhstan
Kuwait=Koweït
Kyrgyzstan=Kirghizistan
Laos=Laos
Lebanon=Liban
Macau=Macao
Malaysia=Malaisie
Maldives=Maldives
Mongolia=Mongolie
Myanmar=Myanmar
Nepal=Népal
Oman=Oman
Pakistan=Pakistan
Philippines=Philippines
Qatar=Qatar
Saudi Arabia=Arabie saoudite
Singapore=Singapour
South Korea=Corée du Sud
Sri Lanka=Sri Lanka
Syria=Syrie
Tajikistan=Tadjikistan
Thailand=Thaïlande
Timor-Leste=Timor oriental
Turkmenistan=Turkménistan
United Arab Emirates=Émirats arabes unis
Uzbekistan=Ouzbékistan
Vietnam=Vietnam
Yemen=Yémen
Anguilla=Anguilla
Antigua and Barbuda=Antigua-et-Barbuda
Aruba=Aruba
Bahamas=Bahamas
Barbados=Barbade
Belize=Belize
Bermuda=Bermudes
British Virgin Islands=Îles Vierges britanniques
Canada=Canada
Cayman Islands=Îles Caïmans
Costa Rica=Costa Rica
Cuba=Cuba
Dominica=Dominique
Dominican Republic=République dominicaine
El Salvador=El Salvador
Grenada=Grenade
Guatemala=Guatemala
Haiti=Haïti
Honduras=Honduras
Jamaica=Jamaïque
Mexico=Mexique
Montserrat=Montserrat
Nicaragua=Nicaragua
Panama=Panama
Saint Kitts and Nevis=Saint-Christophe-et-Niévès
Saint Lucia=Sainte-Lucie
Saint Vincent and the Grenadines=Saint-Vincent-et-les-Grenadines
Trinidad and Tobago=Trinité-et-Tobago
Turks and Caicos Islands=Îles Turques-et-Caïques
United States=États-Unis
Argentina=Argentine
Bolivia=Bolivie
Brazil=Brésil
Chile=Chili
Colombia=Colombie
Ecuador=Équateur
French Guiana=Guyane française
Guyana=Guyana
Paraguay=Paraguay
Peru=Pérou
Suriname=Suriname
Uruguay=Uruguay
Venezuela=Venezuela
Algeria=Algérie
Angola=Angola
Benin=Bénin
Botswana=Botswana
Burkina Faso=Burkina Faso
Cabo Verde=Cap-Vert
Cameroon=Cameroun
Chad=Tchad
Comoros=Comores
Congo (DRC)=Congo (RDC)
Cote d'Ivoire=Côte d'Ivoire
Djibouti=Djibouti
Egypt=Égypte
Equatorial Guinea=Guinée équatoriale
Eswatini=Eswatini
Ethiopia=Éthiopie
Gabon=Gabon
Gambia=Gambie
Ghana=Ghana
Guinea=Guinée
Kenya=Kenya
Lesotho=Lesotho
Liberia=Libéria
Libya=Libye
Madagascar=Madagascar
Mali=Mali
Mauritania=Mauritanie
Mauritius=Maurice
Morocco=Maroc
Mozambique=Mozambique
Namibia=Namibie
Niger=Niger
Nigeria=Nigéria
Rwanda=Rwanda
Senegal=Sénégal
Seychelles=Seychelles
Sierra Leone=Sierra Leone
Somalia=Somalie
South Africa=Afrique du Sud
South Sudan=Soudan du Sud
Sudan=Soudan
Tanzania=Tanzanie
Togo=Togo
Tunisia=Tunisie
Uganda=Ouganda
Zambia=Zambie
Zimbabwe=Zimbabwe
Australia=Australie
Cook Islands=Îles Cook
Fiji=Fidji
French Polynesia=Polynésie française
Guam=Guam
Kiribati=Kiribati
New Caledonia=Nouvelle-Calédonie
New Zealand=Nouvelle-Zélande
Papua New Guinea=Papouasie-Nouvelle-Guinée
Samoa=Samoa
Solomon Islands=Îles Salomon
Tonga=Tonga
Vanuatu=Vanuatu
settings=Paramètres
changeLanguage=Changer de langue
showPersistentNotification=Afficher la notification persistante
switchToLightMode=Passer en mode clair
switchToDarkMode=Passer en mode sombre
faqTitle=Foire aux questions
q1=Qu'est-ce que NetTide ?
a1=NetTide est une application mobile qui vous aide à trouver le meilleur opérateur mobile lorsque vous voyagez.
q2=Comment ça marche ?
a2=NetTide dispose d'une base de données d'opérateurs mobiles du monde entier. Vous pouvez rechercher un pays et obtenir une liste d'opérateurs avec leurs prix par mégaoctet.
q3=Puis-je modifier les prix ?
a3=Oui, vous pouvez modifier le prix de chaque opérateur. C'est utile si vous trouvez une meilleure offre ou si les prix dans l'application sont obsolètes.
q4=Puis-je désactiver des opérateurs ?
a4=Oui, vous pouvez désactiver les opérateurs que vous ne souhaitez pas voir dans la liste.
nettide=NetTide
listOfCountries=Liste des pays
faq=FAQ
enableDisableExpensive=Activer/désactiver les réseaux coûteux
disableAll=Tout désactiver
enableAll=Tout activer
disableAllOperators=Désactiver tous les opérateurs
enableAllOperators=Activer tous les opérateurs
areYouSure=Êtes-vous sûr de vouloir {action} tous les opérateurs ?
cancel=Annuler
allOperatorsDisabled=Tous les opérateurs ont été désactivés.
allOperatorsEnabled=Tous les opérateurs ont été activés.
searchForACountry=Rechercher un pays...
enableDisableExpensiveNetworks=Activer/désactiver les réseaux coûteux
disableNetworksMoreThan=Désactiver les réseaux avec un prix supérieur à
enableNetworksMoreThan=Activer les réseaux avec un prix supérieur à
disable=Désactiver
enable=Activer
expensiveNetworksDisabled=Les réseaux coûteux ont été désactivés.
expensiveNetworksEnabled=Les réseaux coûteux ont été activés.
selectLanguage=Sélectionner la langue
errorDownloadingLanguage=Erreur lors du téléchargement de la langue
modifiedCountries=Pays modifiés
noCountriesModified=Aucun pays n'a encore été modifié.
onboarding1Title=Bienvenue sur NetTide
onboarding1Subtitle=Trouvez le meilleur opérateur mobile lorsque vous voyagez.
onboarding2Title=Modifier les prix
onboarding2Subtitle=Vous pouvez modifier le prix de chaque opérateur.
onboarding3Title=Désactiver les opérateurs
onboarding3Subtitle=Vous pouvez désactiver les opérateurs que vous ne souhaitez pas voir dans la liste.
getStarted=Commencer
skip=Passer
next=Suivant
editPriceFor=Modifier le prix pour
enterNewPricePerMB=Entrez le nouveau prix par Mo
save=Enregistrer
price=Prix
tapToEdit=appuyez pour modifier
