Albania=Albanien
Andorra=Andorra
Armenia=Armenien
Austria=Österreich
Azerbaijan=Aserbaidschan
Belarus=Belarus
Belgium=Belgien
Bosnia and Herzegovina=Bosnien und Herzegowina
Bulgaria=Bulgarien
Croatia=Kroatien
Cyprus=Zypern
Czech Republic=Tschechien
Denmark=Dänemark
Estonia=Estland
Faroe Islands=Färöer
Finland=Finnland
France=Frankreich
Georgia=Georgien
Germany=Deutschland
Gibraltar=Gibraltar
Greece=Griechenland
Greenland=Grönland
Guernsey=Guernsey
Hungary=Ungarn
Iceland=Island
Ireland=Irland
Isle of Man=Isle of Man
Italy=Italien
Jersey=Jersey
Latvia=Lettland
Liechtenstein=Liechtenstein
Lithuania=Litauen
Luxembourg=Luxemburg
Malta=Malta
Moldova=Moldau
Monaco=Monaco
Montenegro=Montenegro
Netherlands=Niederlande
North Macedonia=Nordmazedonien
Norway=Norwegen
Poland=Polen
Portugal=Portugal
Romania=Rumänien
Russia=Russland
San Marino=San Marino
Serbia=Serbien
Slovakia=Slowakei
Slovenia=Slowenien
Spain=Spanien
Sweden=Schweden
Switzerland=Schweiz
Turkey=Türkei
Ukraine=Ukraine
United Kingdom=Vereinigtes Königreich
Afghanistan=Afghanistan
Bahrain=Bahrain
Bangladesh=Bangladesch
Bhutan=Bhutan
Brunei=Brunei
Cambodia=Kambodscha
China=China
Hong Kong=Hongkong
India=Indien
Indonesia=Indonesien
Iran=Iran
Iraq=Irak
Israel=Israel
Japan=Japan
Jordan=Jordanien
Kazakhstan=Kasachstan
Kuwait=Kuwait
Kyrgyzstan=Kirgisistan
Laos=Laos
Lebanon=Libanon
Macau=Macau
Malaysia=Malaysia
Maldives=Malediven
Mongolia=Mongolei
Myanmar=Myanmar
Nepal=Nepal
Oman=Oman
Pakistan=Pakistan
Philippines=Philippinen
Qatar=Katar
Saudi Arabia=Saudi-Arabien
Singapore=Singapur
South Korea=Südkorea
Sri Lanka=Sri Lanka
Syria=Syrien
Tajikistan=Tadschikistan
Thailand=Thailand
Timor-Leste=Osttimor
Turkmenistan=Turkmenistan
United Arab Emirates=Vereinigte Arabische Emirate
Uzbekistan=Usbekistan
Vietnam=Vietnam
Yemen=Jemen
settings=Einstellungen
changeLanguage=Sprache ändern
showPersistentNotification=Dauerhafte Benachrichtigung anzeigen
switchToLightMode=In den Lichtmodus wechseln
switchToDarkMode=In den Dunkelmodus wechseln
faqTitle=Häufig gestellte Fragen
q1=Was ist NetTide?
a1=NetTide ist eine mobile App, die Ihnen hilft, den besten Mobilfunkanbieter auf Reisen zu finden.
q2=Wie funktioniert es?
a2=NetTide verfügt über eine Datenbank mit Mobilfunkanbietern aus aller Welt. Sie können nach einem Land suchen und eine Liste der Anbieter mit ihren Preisen pro Megabyte erhalten.
q3=Kann ich die Preise bearbeiten?
a3=Ja, Sie können den Preis für jeden Anbieter bearbeiten. Dies ist nützlich, wenn Sie ein besseres Angebot finden oder die Preise in der App veraltet sind.
q4=Kann ich Anbieter deaktivieren?
a4=Ja, Sie können Anbieter deaktivieren, die Sie nicht in der Liste sehen möchten.
nettide=NetTide
listOfCountries=Liste der Länder
faq=FAQ
enableDisableExpensive=Teure Netzwerke aktivieren/deaktivieren
disableAll=Alle deaktivieren
enableAll=Alle aktivieren
disableAllOperators=Alle Anbieter deaktivieren
enableAllOperators=Alle Anbieter aktivieren
areYouSure=Sind Sie sicher, dass Sie {action} alle Anbieter möchten?
cancel=Abbrechen
allOperatorsDisabled=Alle Anbieter wurden deaktiviert.
allOperatorsEnabled=Alle Anbieter wurden aktiviert.
searchForACountry=Nach einem Land suchen...
enableDisableExpensiveNetworks=Teure Netzwerke aktivieren/deaktivieren
disableNetworksMoreThan=Netzwerke deaktivieren mit Preis über
enableNetworksMoreThan=Netzwerke aktivieren mit Preis über
disable=Deaktivieren
enable=Aktivieren
expensiveNetworksDisabled=Teure Netzwerke wurden deaktiviert.
expensiveNetworksEnabled=Teure Netzwerke wurden aktiviert.
selectLanguage=Sprache auswählen
errorDownloadingLanguage=Fehler beim Herunterladen der Sprache
modifiedCountries=Geänderte Länder
noCountriesModified=Es wurden noch keine Länder geändert.
onboarding1Title=Willkommen bei NetTide
onboarding1Subtitle=Finden Sie den besten Mobilfunkanbieter, wenn Sie reisen.
onboarding2Title=Preise bearbeiten
onboarding2Subtitle=Sie können den Preis für jeden Anbieter bearbeiten.
onboarding3Title=Anbieter deaktivieren
onboarding3Subtitle=Sie können Anbieter deaktivieren, die Sie nicht in der Liste sehen möchten.
getStarted=Loslegen
skip=Überspringen
next=Weiter
editPriceFor=Preis bearbeiten für
enterNewPricePerMB=Neuen Preis pro MB eingeben
save=Speichern
price=Preis
tapToEdit=Tippen zum Bearbeiten