Albania=Albânia
Andorra=Andorra
Armenia=Armênia
Austria=Áustria
Azerbaijan=Azerbaijão
Belarus=Bielorrússia
Belgium=Bélgica
Bosnia and Herzegovina=Bósnia e Herzegovina
Bulgaria=Bulgária
Croatia=Croácia
Cyprus=Chipre
Czech Republic=República Tcheca
Denmark=Dinamarca
Estonia=Estônia
Faroe Islands=Ilhas Faroé
Finland=Finlândia
France=França
Georgia=Geórgia
Germany=Alemanha
Gibraltar=Gibraltar
Greece=Grécia
Greenland=Gronelândia
Guernsey=Guernsey
Hungary=Hungria
Iceland=Islândia
Ireland=Irlanda
Isle of Man=Ilha de Man
Italy=Itália
Jersey=Jersey
Latvia=Letônia
Liechtenstein=Liechtenstein
Lithuania=Lituânia
Luxembourg=Luxemburgo
Malta=Malta
Moldova=Moldávia
Monaco=Mônaco
Montenegro=Montenegro
Netherlands=Países Baixos
North Macedonia=Macedônia do Norte
Norway=Noruega
Poland=Polônia
Portugal=Portugal
Romania=Romênia
Russia=Rússia
San Marino=San Marino
Serbia=Sérvia
Slovakia=Eslováquia
Slovenia=Eslovênia
Spain=Espanha
Sweden=Suécia
Switzerland=Suíça
Turkey=Turquia
Ukraine=Ucrânia
United Kingdom=Reino Unido
Afghanistan=Afeganistão
Bahrain=Barém
Bangladesh=Bangladesh
Bhutan=Butão
Brunei=Brunéi
Cambodia=Camboja
China=China
Hong Kong=Hong Kong
India=Índia
Indonesia=Indonésia
Iran=Irã
Iraq=Iraque
Israel=Israel
Japan=Japão
Jordan=Jordânia
Kazakhstan=Cazaquistão
Kuwait=Kuwait
Kyrgyzstan=Quirguistão
Laos=Laos
Lebanon=Líbano
Macau=Macao
Malaysia=Malásia
Maldives=Maldivas
Mongolia=Mongólia
Myanmar=Myanmar
Nepal=Nepal
Oman=Omã
Pakistan=Paquistão
Philippines=Filipinas
Qatar=Catar
Saudi Arabia=Arábia Saudita
Singapore=Cingapura
South Korea=Coreia do Sul
Sri Lanka=Sri Lanka
Syria=Síria
Tajikistan=Tajiquistão
Thailand=Tailândia
Timor-Leste=Timor-Leste
Turkmenistan=Turcomenistão
United Arab Emirates=Emirados Árabes Unidos
Uzbekistan=Uzbequistão
Vietnam=Vietnã
Yemen=Iémen
Anguilla=Anguilla
Antigua and Barbuda=Antígua e Barbuda
Aruba=Aruba
Bahamas=Bahamas
Barbados=Barbados
Belize=Belize
Bermuda=Bermudas
British Virgin Islands=Ilhas Virgens Britânicas
Canada=Canadá
Cayman Islands=Ilhas Cayman
Costa Rica=Costa Rica
Cuba=Cuba
Dominica=Dominica
Dominican Republic=República Dominicana
El Salvador=El Salvador
Grenada=Granada
Guatemala=Guatemala
Haiti=Haiti
Honduras=Honduras
Jamaica=Jamaica
Mexico=México
Montserrat=Montserrat
Nicaragua=Nicarágua
Panama=Panamá
Saint Kitts and Nevis=São Cristóvão e Nevis
Saint Lucia=Santa Lúcia
Saint Vincent and the Grenadines=São Vicente e Granadinas
Trinidad and Tobago=Trinidad e Tobago
Turks and Caicos Islands=Ilhas Turcas e Caicos
United States=Estados Unidos
Argentina=Argentina
Bolivia=Bolívia
Brazil=Brasil
Chile=Chile
Colombia=Colômbia
Ecuador=Equador
French Guiana=Guiana Francesa
Guyana=Guiana
Paraguay=Paraguai
Peru=Peru
Suriname=Suriname
Uruguay=Uruguai
Venezuela=Venezuela
Algeria=Argélia
Angola=Angola
Benin=Benim
Botswana=Botsuana
Burkina Faso=Burkina Faso
Cabo Verde=Cabo Verde
Cameroon=Camarões
Chad=Chade
Comoros=Comores
Congo (DRC)=Congo (RDC)
Cote d'Ivoire=Costa do Marfim
Djibouti=Jibuti
Egypt=Egito
Equatorial Guinea=Guiné Equatorial
Eswatini=Eswatini
Ethiopia=Etiópia
Gabon=Gabão
Gambia=Gâmbia
Ghana=Gana
Guinea=Guiné
Kenya=Quênia
Lesotho=Lesoto
Liberia=Libéria
Libya=Líbia
Madagascar=Madagáscar
Mali=Mali
Mauritania=Mauritânia
Mauritius=Maurício
Morocco=Marrocos
Mozambique=Mocambique
Namibia=Namíbia
Niger=Níger
Nigeria=Nigéria
Rwanda=Ruanda
Senegal=Senegal
Seychelles=Seychelles
Sierra Leone=Serra Leoa
Somalia=Somália
South Africa=África do Sul
South Sudan=Sudão do Sul
Sudan=Sudão
Tanzania=Tanzânia
Togo=Togo
Tunisia=Tunísia
Uganda=Uganda
Zambia=Zâmbia
Zimbabwe=Zimbábue
Australia=Austrália
Cook Islands=Ilhas Cook
Fiji=Fiji
French Polynesia=Polinésia Francesa
Guam=Guam
Kiribati=Kiribati
New Caledonia=Nova Caledônia
New Zealand=Nova Zelândia
Papua New Guinea=Papua Nova Guiné
Samoa=Samoa
Solomon Islands=Ilhas Salomão
Tonga=Tonga
Vanuatu=Vanuatu
settings=Configurações
changeLanguage=Alterar idioma
showPersistentNotification=Mostrar notificação persistente
switchToLightMode=Alternar para modo claro
switchToDarkMode=Alternar para modo escuro
faqTitle=Perguntas frequentes
q1=O que é NetTide?
a1=NetTide é um aplicativo móvel que ajuda você a encontrar o melhor operador móvel quando você viaja.
q2=Como funciona?
a2=NetTide possui um banco de dados de operadores móveis do mundo todo. Você pode procurar um país e obter uma lista de operadores com seus preços por megabyte.
q3=Posso editar os preços?
a3=Sim, você pode editar o preço de cada operador. Isso é útil se encontrar uma oferta melhor ou se os preços no aplicativo estiverem desatualizados.
q4=Posso desativar operadores?
a4=Sim, você pode desativar operadores que não deseja ver na lista.
nettide=NetTide
listOfCountries=Lista de países
faq=FAQ
enableDisableExpensive=Ativar/desativar redes caras
disableAll=Desativar tudo
enableAll=Ativar tudo
disableAllOperators=Desativar todos os operadores
enableAllOperators=Ativar todos os operadores
areYouSure=Tem certeza de que deseja {action} todos os operadores?
cancel=Cancelar
allOperatorsDisabled=Todos os operadores foram desativados.
allOperatorsEnabled=Todos os operadores foram ativados.
searchForACountry=Pesquisar um país...
enableDisableExpensiveNetworks=Ativar/desativar redes caras
disableNetworksMoreThan=Desativar redes com preço superior a
enableNetworksMoreThan=Ativar redes com preço superior a
disable=Desativar
enable=Ativar
expensiveNetworksDisabled=Redes caras foram desativadas.
expensiveNetworksEnabled=Redes caras foram ativadas.
selectLanguage=Selecionar idioma
errorDownloadingLanguage=Erro ao baixar o idioma
modifiedCountries=Países modificados
noCountriesModified=Ainda não há países modificados.
onboarding1Title=Bem-vindo ao NetTide
onboarding1Subtitle=Encontre o melhor operador móvel quando você viaja.
onboarding2Title=Editar preços
onboarding2Subtitle=Você pode editar o preço de cada operador.
onboarding3Title=Desativar operadores
onboarding3Subtitle=Você pode desativar operadores que não deseja ver na lista.
getStarted=Começar
skip=Pular
next=Próximo
editPriceFor=Editar preço para
enterNewPricePerMB=Digite o novo preço por MB
save=Salvar
price=Preço
tapToEdit=toque para editar
