Albania=Albania
Andorra=Andorra
Armenia=Armenia
Austria=Austria
Azerbaijan=Azerbaiyán
Belarus=Bielorrusia
Belgium=Bélgica
Bosnia and Herzegovina=Bosnia y Herzegovina
Bulgaria=Bulgaria
Croatia=Croacia
Cyprus=Chipre
Czech Republic=República Checa
Denmark=Dinamarca
Estonia=Estonia
Faroe Islands=Islas Feroe
Finland=Finlandia
France=Francia
Georgia=Georgia
Germany=Alemania
Gibraltar=Gibraltar
Greece=Grecia
Greenland=Groenlandia
Guernsey=Guernsey
Hungary=Hungría
Iceland=Islandia
Ireland=Irlanda
Isle of Man=Isla de Man
Italy=Italia
Jersey=Jersey
Latvia=Letonia
Liechtenstein=Liechtenstein
Lithuania=Lituania
Luxembourg=Luxemburgo
Malta=Malta
Moldova=Moldavia
Monaco=Mónaco
Montenegro=Montenegro
Netherlands=Países Bajos
North Macedonia=Macedonia del Norte
Norway=Noruega
Poland=Polonia
Portugal=Portugal
Romania=Rumanía
Russia=Rusia
San Marino=San Marino
Serbia=Serbia
Slovakia=Eslovaquia
Slovenia=Eslovenia
Spain=España
Sweden=Suecia
Switzerland=Suiza
Turkey=Turquía
Ukraine=Ucrania
United Kingdom=Reino Unido
Afghanistan=Afganistán
Bahrain=Baréin
Bangladesh=Bangladés
Bhutan=Bután
Brunei=Brunéi
Cambodia=Camboya
China=China
Hong Kong=Hong Kong
India=India
Indonesia=Indonesia
Iran=Irán
Iraq=Irak
Israel=Israel
Japan=Japón
Jordan=Jordania
Kazakhstan=Kazajistán
Kuwait=Kuwait
Kyrgyzstan=Kirguistán
Laos=Laos
Lebanon=Líbano
Macau=Macao
Malaysia=Malasia
Maldives=Maldivas
Mongolia=Mongolia
Myanmar=Myanmar
Nepal=Nepal
Oman=Omán
Pakistan=Pakistán
Philippines=Filipinas
Qatar=Catar
Saudi Arabia=Arabia Saudita
Singapore=Singapur
South Korea=Corea del Sur
Sri Lanka=Sri Lanka
Syria=Siria
Tajikistan=Tayikistán
Thailand=Tailandia
Timor-Leste=Timor Oriental
Turkmenistan=Turkmenistán
United Arab Emirates=Emiratos Árabes Unidos
Uzbekistan=Uzbekistán
Vietnam=Vietnam
Yemen=Yemen
Anguilla=Anguila
Antigua and Barbuda=Antigua y Barbuda
Aruba=Aruba
Bahamas=Bahamas
Barbados=Barbados
Belize=Belice
Bermuda=Bermudas
British Virgin Islands=Islas Vírgenes Británicas
Canada=Canadá
Cayman Islands=Islas Caimán
Costa Rica=Costa Rica
Cuba=Cuba
Dominica=Dominica
Dominican Republic=República Dominicana
El Salvador=El Salvador
Grenada=Granada
Guatemala=Guatemala
Haiti=Haití
Honduras=Honduras
Jamaica=Jamaica
Mexico=México
Montserrat=Montserrat
Nicaragua=Nicaragua
Panama=Panamá
Saint Kitts and Nevis=San Cristóbal y Nieves
Saint Lucia=Santa Lucía
Saint Vincent and the Grenadines=San Vicente y las Granadinas
Trinidad and Tobago=Trinidad y Tobago
Turks and Caicos Islands=Islas Turcas y Caicos
United States=Estados Unidos
Argentina=Argentina
Bolivia=Bolivia
Brazil=Brasil
Chile=Chile
Colombia=Colombia
Ecuador=Ecuador
French Guiana=Guayana Francesa
Guyana=Guyana
Paraguay=Paraguay
Peru=Perú
Suriname=Surinam
Uruguay=Uruguay
Venezuela=Venezuela
Algeria=Argelia
Angola=Angola
Benin=Benín
Botswana=Botsuana
Burkina Faso=Burkina Faso
Cabo Verde=Cabo Verde
Cameroon=Camerún
Chad=Chad
Comoros=Comoras
Congo (DRC)=Congo (RDC)
Cote d'Ivoire=Costa de Marfil
Djibouti=Djibouti
Egypt=Egipto
Equatorial Guinea=Guinea Ecuatorial
Eswatini=Esuatini
Ethiopia=Etiopía
Gabon=Gabón
Gambia=Gambia
Ghana=Ghana
Guinea=Guinea
Kenya=Kenia
Lesotho=Lesoto
Liberia=Liberia
Libya=Libia
Madagascar=Madagascar
Mali=Mali
Mauritania=Mauritania
Mauritius=Mauricio
Morocco=Marruecos
Mozambique=Mozambique
Namibia=Namibia
Niger=Níger
Nigeria=Nigeria
Rwanda=Ruanda
Senegal=Senegal
Seychelles=Seychelles
Sierra Leone=Sierra Leona
Somalia=Somalia
South Africa=Sudáfrica
South Sudan=Sudán del Sur
Sudan=Sudán
Tanzania=Tanzania
Togo=Togo
Tunisia=Túnez
Uganda=Uganda
Zambia=Zambia
Zimbabwe=Zimbabue
Australia=Australia
Cook Islands=Islas Cook
Fiji=Fiyi
French Polynesia=Polinesia Francesa
Guam=Guam
Kiribati=Kiribati
New Caledonia=Nueva Caledonia
New Zealand=Nueva Zelanda
Papua New Guinea=Papúa Nueva Guinea
Samoa=Samoa
Solomon Islands=Islas Salomón
Tonga=Tonga
Vanuatu=Vanuatu
settings=Configuración
changeLanguage=Cambiar idioma
showPersistentNotification=Mostrar notificación persistente
switchToLightMode=Cambiar a modo claro
switchToDarkMode=Cambiar a modo oscuro
faqTitle=Preguntas frecuentes
q1=¿Qué es NetTide?
a1=NetTide es una aplicación móvil que te ayuda a encontrar el mejor operador móvil cuando viajas.
q2=¿Cómo funciona?
a2=NetTide tiene una base de datos de operadores móviles de todo el mundo. Puedes buscar un país y obtener una lista de operadores con sus precios por megabyte.
q3=¿Puedo editar los precios?
a3=Sí, puedes editar el precio de cada operador. Esto es útil si encuentras una mejor oferta o si los precios en la aplicación están desactualizados.
q4=¿Puedo desactivar operadores?
a4=Sí, puedes desactivar operadores que no quieras ver en la lista.
nettide=NetTide
listOfCountries=Lista de países
faq=FAQ
enableDisableExpensive=Activar/desactivar redes caras
disableAll=Desactivar todo
enableAll=Activar todo
disableAllOperators=Desactivar todos los operadores
enableAllOperators=Activar todos los operadores
areYouSure=¿Estás seguro de que quieres {action} todos los operadores?
cancel=Cancelar
allOperatorsDisabled=Todos los operadores han sido desactivados.
allOperatorsEnabled=Todos los operadores han sido activados.
searchForACountry=Buscar un país...
enableDisableExpensiveNetworks=Activar/desactivar redes caras
disableNetworksMoreThan=Desactivar redes con precio superior a
enableNetworksMoreThan=Activar redes con precio superior a
disable=Desactivar
enable=Activar
expensiveNetworksDisabled=Se han desactivado las redes caras.
expensiveNetworksEnabled=Se han activado las redes caras.
selectLanguage=Seleccionar idioma
errorDownloadingLanguage=Error al descargar el idioma
modifiedCountries=Países modificados
noCountriesModified=Aún no se han modificado países.
onboarding1Title=Bienvenido a NetTide
onboarding1Subtitle=Encuentra el mejor operador móvil cuando viajas.
onboarding2Title=Editar precios
onboarding2Subtitle=Puedes editar el precio de cada operador.
onboarding3Title=Desactivar operadores
onboarding3Subtitle=Puedes desactivar operadores que no quieras ver en la lista.
getStarted=Comenzar
skip=Omitir
next=Siguiente
editPriceFor=Editar precio para
enterNewPricePerMB=Introduce un nuevo precio por MB
save=Guardar
price=Precio
tapToEdit=toca para editar
